00000000000000000000
00000000000000000000
11111111111111111111
00000000000000000000
00000000000000000000
00000000000000000000
00000011110000000000
00000003330000000000
00000000000000000000
00000033333330000000
00000000000000000000
00000000222200000000
00000000000000000000
00000000033300000000
00000000000000000000
00000000000000000000
00003333333330000000
00000000000000000000
00000000000000000000
00000000000000000000